90
0
13
0
5
3
1
-1
+F+C+F+F+
FXFXCXFXC
+F+F+C+F+
CXFXFXFXF
+F+F+C+F+