90
0
13
1
5
3
1
-2
+F+F+X+F+
FXFXTXXXF
+F+X+F+F+
XXFXFXFXF
+F+X+T+F+