90
0
13
0
5
3
3
-1
+F+C+F+C+
FXFXTXTXT
+F+C+T+F+
TXFXFXFXF
+F+F+T+F+